F 120,117,29
C 105,105,105

NO textures/WallCandles.xpm
SO textures/WallSkeleton.xpm
WE textures/WallSkulls.xpm
EA textures/WallSkeletonGrave.xpm

11111
10001
10S0111111111111
1000100000000001
10G0100000000001
1000D0000n000X01
1000100000000001
1000100000000001
1000111111111111
100011111111111111111
100000000000000000001
100000000000000000001
100000000000000000001
111111111111111111111