F 20,14,14
C 40,7,7

NO textures/WallCandles.xpm
SO textures/WallSkeleton.xpm
WE textures/WallSkulls.xpm
EA textures/WallSkeletonGrave.xpm

11111111111111111111
100000000D0000000001
10000000010000000001
111D1111111111DD1111
10000100000000000001
10000D00000000000001
1000010000001111DD11
11011111111110000001
10000100000010000001
10N001000000D0000001
10000100000010000001
11111111111111111111

