F 76,76,76
C 99,99,99

NO textures/north.xpm
SO textures/south.xpm
WE textures/west.xpm
EA textures/east.xpm

1111111111111111111
1001001001101000101
1011000000001111011
1001001000000001111
100111100N000110001
1000000000000001001
1111111111111111111