F 76,76,76
C 99,99,99

NO textures/north.xpm
SO textures/south.xpm
WE textures/west.xpm
EA textures/east.xpm

11111111111111111111
10010001111110000001
1011001     11111011
10010011111110011111
10011110000001100001
1S000000000000000001
11111111111111111111