F 76,76,76
C 99,99,99

NO textures/north.xpm
SO textures/south.xpm
WE textures/west.xpm
EA textures/east.xpm

11111111111111111111
10000001111110000001
1000001     11111011
10000001111111011111
10000000000000100001
100N0000000001000001
11111111111111111111

