F 20,14,14
C 40,7,7

NO textures/WallCandles.xpm
SO textures/WallSkeleton.xpm
WE textures/WallSkulls.xpm
EA textures/WallSkeletonGrave.xpm

11111111111111111111     
10000000000000000001
1000n001111110000001
100c001000000100000111111
1000000111111000000000001
1000000000000000000111111
10000000000000000001
10001111D111D1110001
1000010A000000000001
10R0010000000C000s01
10000D0Q00000000|001
1W00010000G000O00001
100V0100000000000001
11111111111111111111