F 20,14,14
C 40,7,7

NO textures/WallCandles.xpm
SO textures/WallSkeleton.xpm
WE textures/WallSkulls.xpm
EA textures/WallSkeletonGrave.xpm

11111111111111111111     
10000000000000000001
10000001111110000001
1000001      100000111111
1000000111111000000000001
1000000000000000000111111
10000000000000000001
10001111D11111110001
10000000000000000001
10000000000000000001
10000000000000000001
10000000000000000001
10N00000000000000001
11111111111111111111

