F 26,24,28
C 4,3,23

NO textures/txt_lvl2/wall_txt_1.xpm
SO textures/txt_lvl2/wall_txt_2.xpm
WE textures/txt_lvl2/wall_txt_3.xpm
EA textures/txt_lvl2/wall_txt_4.xpm

        111111
        110001
        1000001
        100H001
        1000001
        11D1111111
        1001000001
        100111D111
        100D000001
    11111001000001
    1000100111D1111111111111111111
    10H0D00010000D000000000000Q001
    100010001000010000000000000001
    111110001000011111111111111111
        1000100001
        10H0100001
        1000100001
        111111D111
        1000100001
        1000100001
        1000100001
   111111000100001111111111        11111
   1Q0001000D000000000Q0001     11110001111
   100001000100000000000001     10000000001
   1000010001111111111111111111110000000001
   100001000D0000000000000000000100000000011
   1000010H0100000000000Q0000000D00000E00X01
   10000D00010000000000000000000100000000011
   11D1111111111111111111111111110000000001
   100001                       10000000001
   100001                       11110001111
   100001                          11111
   100001
111100001111
100000000001
100000000001
10O000000Q01
111111111111