F 26,24,28
C 4,3,23

NO textures/WallCandles.xpm
SO textures/WallSkeleton.xpm
WE textures/WallSkulls.xpm
EA textures/WallSkeletonGrave.xpm

        1111111111111111111111
        1000000000010000000001
        10H0000000010000000001
        1000000000010000000001
        1111111000011111D11111
   111111000001000010000000001
   1QC00D00000D0H0010000000001
   111111111111000010000111111
   1000000000000000100001
   1000011111111111100001
   10000100H0000000000001
   111D11111111111111D111
   100001          100001
   100001          100001
111100001          100001
1E0000|01          100001
100000001          100001
111111111          100001
                   10H001
                   100001
                   100001
             111111111D11111111
             100000000000000001
             100000000000000001
             100000000000000001
             111111111111111111