F 20,14,14
C 40,7,7

NO textures/txt_lvl2/wall_txt_1.xpm
SO textures/txt_lvl2/wall_txt_2.xpm
WE textures/txt_lvl2/wall_txt_3.xpm
EA textures/txt_lvl2/wall_txt_4.xpm

             11111
        1111110S01
        1000000001
	1000000001
	1000000001
	1111D11111
	1000000001
	1000000001
	1000000001
    111110000000011111111111111111
    100010000000010000000000000001
    1000D00000000D0000000000000001
    100010000000010000000000000001
    111110000000011111111111111111
        1000000001
	1000000001
	1000000001
	1111D11111
	1000000001
	1000000001
	1000000001
   111111000000001111111111        11111
   100001000000000000000001     11110001111
   100001000000000000000001     10000000001
   10000D0000000000000000011111110000000001
   10000100000000000000000000000100000000011
   10000100000000000000000000000D00000000001
   10000100000000000000000000000100000000011
   11D1111111111111111111111111110000000001
   100001                       10000000001
   100001                       11110001111
   100001                          11111
   100001
111100001111
100000000001
100000000001
100000000001
111111111111