F 54,30,41
C 24,48,58

NO textures/txt_lvl1/forest1.xpm
SO textures/txt_lvl1/forest1.xpm
WE textures/txt_lvl1/forest2.xpm
EA textures/txt_lvl1/forest3.xpm

        1111111111111111111111
        1000000000010000000001
        10H000k0000000000s0001
   111111000000000010000000001
   10Qc01111111000011111011111
   10C011000001000010000000001
   1000000000000H0010000000001
   11111111111100v010000111111
   1000000000000000100001
   10R0011111111111100001
   10000100H0000000000001
   1110111111111111110111
   100001          100001
   100001          100001
111100001          100001
100000|01          100001
1E0000001          100001
111111111          100001
                   10H001
                   100001
                   100001
                 1111101111
                 1000000001
                 1000000001
                 1000000001
                 1000p00001
                 1000000001
                 1000X00001
                 1111111111