F 20,14,14
C 40,7,7

NO textures/txt_lvl2/wall_txt_1.xpm
SO textures/txt_lvl2/wall_txt_2.xpm
WE textures/txt_lvl2/wall_txt_3.xpm
EA textures/txt_lvl2/wall_txt_4.xpm

        1111111111111111111111
        1000000000010000000001
        10H00000000D0000000001
        1000000000010000000001
        1111111000011111D11111
   111111000001000010000000001
   1QC00D00000D0H0010000000001
   111111111111000010000111111
   1000000000000000100001
   1000011111111111100001
   10000100H0000000000001
   111D11111111111111D111
   100001          100001
   100001          100001
111100001          100001
100000|01          100001
100000001          100001
111111111          100001
                   10H001
                   100001
                   100001
                 11111D1111
                 1000000001
                 1000000001
                 1000000001
                 1000S0|001
                 100000C001
                 1000X00001
                 1111111111