F 20,14,14
C 40,7,7

NO textures/WallCandles.xpm
SO textures/WallSkeleton.xpm
WE textures/WallSkulls.xpm
EA textures/WallSkeletonGrave.xpm

              1111111111111        1111111
              1kG0D00000001        10s0v01
              1111111000111        100R001
                    10001          1100011
                    10001111        10001
                    10000001        10001
                    111110v11111111111D11
                        10000000000000001
                        11111111111110001
111111111                           10001
10k000c01                           10001
1000R0001                           10001
100000001                           10001
111000111            11111111111111110001
  10001              100000D00k0000000001        111111
  10001              10001111000111110001       11000011
  10001      1111111110001  10001   10001      1100k00011
  100011111111000000010001  10001   10001     110000000011
  10s00000000D000c000D0001  10001   10001111111000000000011
  11111111111100000R011111  10001   10v000000000000n000X011
             111110001      10001   1111111111100000000011
                 10001    111000111           11000000011
                 10001    100000s01            1100k0011
                 10001    1000R0001             1100011
                 10001    111000111              11111
                 10001      10001
                 1000111111110001
                 10000000D0000001
             11111000011111111111
             1000000001
             10000v0001
             1000R00001111
             100000000|001
             1111111000001
                   100N001
                   1111111