F 30,30,37
C 0,0,0

NO textures/txt_lvl2/wall_txt_4.xpm
SO textures/txt_lvl2/wall_txt_1.xpm
WE textures/txt_lvl2/wall_txt_2.xpm
EA textures/txt_lvl2/wall_txt_3.xpm

        111111
        110S01
        1000001
        100R|01
        1000001
        11D1111111
        1001000001
        100111D111
        100D000001
    11111001000001
    1000100111D1111111111111111111
    10R0D00010000D000000v00000Q001
    100010001000010000000000000001
    1111100010c0011111111111111111
        1000100001
        10R0100001
        1000100001
        111111D111
        1000100001
        1000100001
        1000100001
   111111000100001111111111        11111
   100001000D000s00000Q0001     11110001111
   10k0010v0100000000000001     10000000001
   100R010001111111111111111111110000000001
   100001000D0000000000000000000100000000011
   1000010R01000000v0000Q000c000D0000w000X01
   10000D00010000000000000000000100000000011
   11D1111111111111111111111111110000000001
   100001                       10000000001
   100001                       11110v01111
   100001                          11111
   100001
111100001111
10k000000k01
100000000001
10O000000Q01
111111111111