F 90,76,76
C 99,99,99

NO textures/north.xpm
SO textures/south.xpm
WE textures/west.xpm
EA textures/east.xpm

11111111111111111111
10000000000000000001
10000001111110000001
1000001      1000001
10000001111110000001
100N0000000000000001
10000000011000000001
10001100011000110001
10000000011000000001
10000000000000000001
11111111111111111111

